+-+-+-+-+-+-+-+-+
|b|   | | |     |
+ +-+ + + +-+ +-+
|   |   |       |
+ + + +-+ +-+ +-+
| |   |     |   |
+ +-+-+ +-+-+ +-+
|       |       |
+-+ + +-+-+ +-+-+
|               |
+-+-+ + + +-+-+-+
|   |     |     |
+-+-+ + +-+-+-+-+
|     |       c |
+-+-+-+-+-+-+-+-+